impressed | 형. 감명깊게 생각하는, 감명을 받은 
position | 일자리, 직책; 두다 
refer | 참조하다 
managerial | 형. 관리의
supervisory | 형. 감독의, 관리의
be eligible for + N / to VR | ~할 자격이 있다
in association with | ~와 제휴하여
confidence in | ~에 대한 확신, 신임 
tidy | 형. 단정한, 깔끔한
be associated with | ~와 관련되다
confidence | 확신, 자신; 신임 
lack | ~이 없다, 부족 
employment | 고용
apply for a position | 일자리에 지원하다 
achievement | 성취, 달성 
wage | 급료, 임금 
qualifications for | ~에 대한 자격
diligently | 부. 부지런히, 열심히
candidate | 후보자, 지원자 
show / express + confidence in | ~에 대한 신념을 보이다 
be familiar with | ~에 익숙하다
consultation | 상담
impressive | 형. 인상적인
achiever | 크게 성공한 사람 
criteria | 기준
consult + 자료 | ~을 찾아보다, 참고하다 
prospect | 전망, 예상 
apply for | ~에 지원하다 
appliance | 전자제품 
insufficient | 형. 불충분한 
profession | 직업
career | 직업, 경력 
be entitled to N / VR | ~할 자격이 주어지다
appeal to N | ~에 흥미를 끌다, ~에게 호소하다 
accupation | 직업
salary | 연봉
party | 단체, 연회, 정당 
part-time | 형. 시간제의
applicant | 지원자, 신청자
diligent | 형. 성실한 
graduation | 졸업 
eligible | 형. 자격이 있는, 적격의 
employ | 고용하다 
be advised to VR | ~할 것을 권유받다 
identify | 알아보다, 확인하다 
plentiful | 형. 풍부한
reference | 추천서; 참고 
meet | 만족시키다 
send in | ~을 제출하다 
highly | 부. 매우, 대단히
at all time | 항상, 언제나
at no cost | 무료로
in detail | 자세히
as a result of | ~의 결과로, ~으로 인해
on schedule | 예정대로
upon request | 요청(신청) 하면 
in effect | 시행중인, 유효한 
aside from | ~이외에, 덧붙여
in advance | 미리, 먼저 
at the latest | 늦어도